00000000000000000000000000000000000000000000000000000000000000000000000000000000000000000000000000000000000000000000000000000000000000000000000000000000000000000000000000000000000000000000000000000000000000000000000000000000000000000000000000000000000000000000000000000000000000000000000000
00000000000000000000000000000000000000000000000000000000000000000000000000000000000000000000000000000000000000000000000000000000000000000000000000000000000000000000000000000000000000000000000000000000000000000000000000000000000000000000000000000000000000000000000000000000000000000000000000
00000000000000000000000000000000000000000000000000000000000000000000000000000000000000000000000000000000000000000000000000000000000000000000000000000000000000000000000000000000000000000000000000000000000000000000000000000000000000000000000000000000000000000000000000000000000000000000000000
00000000000000000000000000000000000000000000000000000000000000000000000000000000000000000000000000000000000000000000000000000000000000000000000000000000000000000000000000000000000000000000000000000000000000000000000000000000000000000000000000000000000000000000000000000000000000000000000000
00000000000000000000000000000000000000000000000000000000000000000000000000000000000000000000000000000000000000000000000000000000000000000000000000000000000000000000000000000000000000000000000000000000000000000000000000000000000000000000000000000000000000000000000000000000000000000000000000
00000000000000000000000000000000000000000000000000000000000000000000000000000000000000000000000000000000000000000000000000000000000000000000000000000000000000000000000000000000000000000000000000000000000000000000000000000000000000000000000000000000000000000000000000000000000000000000000000
00000000000000000000000000000000000000000000000000000000000000000000000000000000000000000000000000000000000000000000000000000000000000000000000000000000000000000000000000000000000000000000000000000000000000000000000000000000000000000001111000000000000000000000000000000000000000000000000000
00000000000000000000000000000000000000000000000000000000000000000000000000000000000000000111110000000000000000000000000000000000000000000000000000000000000000000000000000000000111110000000000000000000000111110000000000000000000000000001111000000001111100000000000000000000000000000000000000
00000000000000000000000000000000000000000000000000000000000000000000000000000000000000000111110000000000011111100000000000000000000000000000000000000000000000000000000000000000111110000000000011111000000111110000000000000000000000011111111100000000111111000000000000000000000000000000111111
00000000000000000000000000000000000000000000000000000000000000000000000000000000000000000111110000000000011111100000000001111100001111100000000000000000000000000001111111100000111110000000000011111000000111110000000000011110000000011111111100000000111111111110000001111100000111000011111100
00000000000000000000000000000000000000000000000000000000000111111111000000000000000001111111110000000000011111100000000001111100001111100000000000000011111100000001111111100000111110000000111111111000000111111111110000001111000000011111111100000000111111111110000001111100000111000011111100
00000000000000000000000000000000000000000000000000000000000111111111000001111110000001111111110000000111111111111110000001111100001111100000011110000011111100000001111111100000111110000000111111111000000111111111110000001111000000011111111100000000111111111110000001111100000111000001111110
00000000000000000000000000000011111111111111100000000000000111111111000001111110000001111111110000000111111111111110000001111100001111100000011110000011111100000001111111100000111110000000111111111000000111111111110000001111000000011111111100000000111111111110000001111100000011100000111111
11111111111111111111100000000011111111111111100000001111111111111111000001111110000001111111110000000111111111111110000001111111111111100000011110000011111100000001111111100000111110000000111111111000000111111111110000001111000000011111111100000001111111111100000011111000000111000001111110
11111111111111111111100000000011111111111111100000001111111111111111000001111110000001111111110000000111111111111110000001111111111111100000011110000011111100000001111111100000111110000000111111111000000111111111110000001111000000011111111100000001111111111100000011111000000111000001111110
11111111111111111111100000000011111111111111100000001111111111111111000001111110000001111111110000000111111111111110000001111111111111100000011110000011111100000001111111100000111110000000111111111000000111111111110000001111000000011111111100000001111111111100000011111000000111000001111110
11111111111111111111100000000011111111111111100000001111111111111111000001111110000001111111110000000111111111111110000001111111111111100000011110000011111100000001111111100000111110000000111111111000000111111111110000001111000000011111111100000001111111111100000011111000000111000001111110